11111111
1P000001
10O00E01
1000C001
11111111