111111111111111111111111111111111111111111111111111111
101111111111111111111111111111111111111111111111111111
1C00000000000000000000000000000000000000000000000000C1
111111111111111111111111111111111111111111111111111101
1C00000000000000000000000000000000000000000000000000C1
101111111111111111111111111011101110111011101110111011
1C00000000000000000000000P111C111C111C111C111C111C1101
101111111111111111111111111110111011101110111011101111
100000000000000000000000000000000000000000000000000001
111111111111111111111111111111111111111111111111111101
1E0000000000000000000000000000000000000000000000000001
111111111111111111111111111111111111111111111111111111