11111111
1P000001
10000001
1000C001
11111111