11111111
1P000E01
10000001
10000001
11111111