1111111
1P001E1
1000011
10C1C01
1111111
