11111111
1C000E01
1000C001
10000001
11111111