1111111
1P000E1
1111C01
10C1C01
1111111