11101111
1P000001
10000000
0000C001
11101111