11111111111111
1P000C00001001
100000100010C1
1000C010000001
11100000000001
10C0001100E001
11111111111111