11111111111111111111111
111000000000000000C0111
100C0000000P00000001111
11100000110000010000001
10000000000000000000C01
11111111100001111111111
10000000000E00000C00001
1110C000010111000000011
11111111111111111111111