1111111
1P0E0C1
1111111
1111111
1111111