1111111
1P0P0E1
1000001
1000C01
1111111